11111111111111111111111111111111111111111|
00000000000000000000X00000000000000000000|
01111111001111111111100000111111111111110|
01111100001111111111101110111111111111110|
01111001100111111111101110111111111111110|
01111011110001111111101110111111111111110|
01111011111101111111101110111111111111110|
01111111111100111111111000111111111111110|
01111111111110011111110011111111111111110|
01111111111111001111100111111111111111110|
01111111111111101111101111111111111111110|
01111111111111101111101111111111111111110|
01111111111111101111101111111111111111110|
01111111111111101111101111111111111111110|
01111111111111101111101111111111111111110|
01111111111111101111101111111111111111110|
01111111111111101111101111111111111111110|
01111111111111100011101111111111111111110|
01111111111111111111101111111111111111110|
00000000000000000000I00000000000000000000|
00000000000000000000000000000000000000000|