11111111111111111111111111111111111111111|
00000000000000000000X00000000000000000000|
01111111111111111111111111111111111111110|
01111111111111111111111111111111111111110|
01111111111111111111111111111111111111110|
01110001111111111111111111111111111111110|
01111111111111111111111111111111111111110|
01111111111111111111111111111111111111110|
01111111111111111111111111111111111111110|
01111111111111111111111111111111111111110|
01111111111111111111111111111111111111110|
01111111111111111111111111111111111111110|
01111111111111111111111111111111111111110|
01111111111111111111111111111111111111110|
01111111111111111111111111111111111111110|
01111111111111111111111111111111111111110|
01111111111111111111111111111111111111110|
01111111111111111111111111111111111111110|
01111111111111111111111111111111111111110|
00000000000000000000I00000000000000000000|
00000000000000000000000000000000000000000|