11111111111111111111111111111111111111111|
00000000000000000000X00000000000000000000|
01111111111111111111111111111111111111100|
01111111111111111111111111111111111111100|
01111111111111111111111111111111001111100|
00000000000000000000000000000000000011100|
01111111111111111111111111111111111111100|
01111111111111111111111111111111111111100|
01111111111111111111111111111111111111100|
01111111111111111111111111111111111111100|
01111111111111111111111111111111111111100|
01111111111111111111111111111111111111100|
01111111111111111111111111111111111111100|
01111111111111111111111111111111111111100|
01111111111111111111111111111111111111100|
01111111111111111111111111111111111111100|
01111111111111111111111111111111111111100|
01111111111111111111111111111111111111100|
01111111111111111111111111110000000000000|
00000000000000000000I00000000000000000000|
00000000000000000000000000000000000000000|