00000000000000000000000000000000000000000|
11111111111111111111X11111111111111111111|
10000000010000000000000000000000000000001|
10000000010000000000000000000000000000001|
10000000010000000000000000000000000000001|
10000000000000000000000000000000000000001|
10000000000000000000000000000000000000001|
10000000000000000000000000000000000000001|
10000000000000000000000000000000000000001|
10000000000000000000000000000000000000001|
10000000000000000000000000000000000000001|
10000000000000000000000000000000000000001|
10000000000000000000000000000000000000001|
10000000000000000000000000000000000000001|
10000000000000000000000000000000000000001|
10000000000000000000000000000000000000001|
10000000000000000000000000000000000000001|
10000000000000000000000000000000000000001|
10000000000000000000000000000000000000001|
11111111111111111111I11111111111111111111|
|