00000000X00000000000000000000000000000000|
000000100000000110000000000000000000000|
000000100000000010000000000000000000000|
000000100000000011100000000000000000000|
000001100000000010000000000000000000000|
000011100000000010000000000000000000000|
000010100000000110000000000000000000000|
000010100000011100000000000000000000000|
000010111001110000000000000000000000000|
000010101101000000000000000000000000000|
000011100111000000000000000000000000000|
000010000000000000000000000000000000000|
000010000000000000000000000000000000000|
000010000000000000000000000000000000000|
000010000000000000000000000000000000000|
000010000000000000000000000000000000000|
000010000000000000000000000000000000000|
000010000000000000000000000000000000000|
0000I0000000000000000000000000000000000|
000000000000000000000000000000000000000|